%s ago=%s 전
%s used of %s %s %%=%s 사용됨, 총 %s (%s %%)
1 m=1분
10 s=10초
2 m=2분
30 s=30초
5 m=5분
Abort background operation=백그라운드 작업 중단
Abort background process=백그라운드 프로세스 중단
Active tunnels=활동 중인 터널
Activity=활동
ago=전
Airflow=공기 흐름
Alert Message=경고 메시지
Alerts=경고
All Apps=모든 앱
All VMs=모든 VM
Array Information=어레이 정보
Attention - operation continues in background=주의 - 작업은 백그라운드에서 계속됩니다
Battery charge=배터리 충전
BIOS dated=BIOS 날짜
Click to toggle CPU chart=클릭해서 CPU 차트를 전환
Click to toggle details=클릭해서 자세한 정보 보기
Close Tile=타일 닫기
Completed=완료됨
Content Management=항목 관리
Counters info=카운터 정보
Current operation %s on %s=진행중인 작업 %s, **%s** 부터
custom image=사용자 지정 사진
Data is invalid=데이터가 유효하지 않음
default image=기본 이미지
Docker Containers=Docker 컨테이너
Due in=다음 검사일
Elapsed time=소요된 시간
Errors info=오류 정보
Estimated finish=예상 완료
failed device=개의 장치가 실패했습니다
Fan count=팬 개수
Fan Information=팬 정보
FAN=팬
Finding %s error=**%s**개의 오류가 발견됨
Finding %s errors=**%s**개의 오류가 발견됨
General info=일반 정보
Go to CPU pinning settings=CPU pinning 설정으로 이동
Go to disk settings=디스크 설정으로 이동
Go to Docker settings=Docker 설정으로 이동
Go to fan settings=팬 설정으로 이동
Go to identification settings=식별 설정으로 이동
Go to network settings=네트워크 설정으로 이동
Go to scheduler settings=스케줄러 설정으로 이동
Go to Share settings=공유 설정으로 이동
Go to UPS settings=UPS 설정으로 이동
Go to User settings=사용자 설정으로 이동
Go to VM settings=VM 설정으로 이동
Go to VPN settings=VPN 설정으로 이동
Handshake=핸드세이크
has=에서
healthy=정상
heat warning=발열 경고
Hide details=자세한 정보 숨기기
in progress=진행 중
Inactive tunnels=비활성화된 터널
inactive=비활성화
Inbound=인바운드
Information=정보
Interface Information=인터페이스 정보
invalid device=유효하지 않은 장치
invalid devices=유효하지 않은 장치
Last check completed on %s=마지막 검사가 **%s**에 완료됨
Last check incomplete on %s=마지막 검사가 **%s**에 완료되지 않음
Last checked on %s=마지막으로 **%s**에 검사됨
Lock sortable items=정렬 가능한 항목 잠금
Maximum size=최대 용량
Memory Utilization=메모리 사용량
Mode of operation=작동 모드
Motherboard Information=메인보드 정보
Network traffic=네트워크 트래픽
Next check scheduled on %s=다음 검사가 **%s**에 예약됨
No docker containers defined=정의된 Docker 컨테이너가 없음
No running docker containers=실행중인 Docker 컨테이너가 없음
No running virtual machines=실행중인 가상 머신이 없음
No shares present=공유가 존재하지 않음
No virtual machines defined=정의된 가상 머신이 없음
Nominal power=공칭 전력
not received=수신되지 않음
Notices=공지
Notifications=알림
Only PNG images are allowed=PNG 이미지만 사용 가능합니다!
Outbound=아웃바운드
Output voltage=출력 전압
Overall Load=전체 부하
Parity disk not present=패리티 디스크 없음
Parity disks not present=패리티 디스크 없음
Parity has not been checked yet=패리티가 아직 검사되지 않음
Parity is degraded=패리티 성능이 저하됨
Pool=풀
Power Status=전원 상태
Power=전원
Processor Information=프로세서 정보
Put system to sleep=시스템을 절전 모드로 전환
Reboot the system=시스템 재가동
Receive counters=수신 카운터
Received packets=수신된 패킷
Runtime left=남은 시간
Scheduled parity check is disabled=예약된 패리티 검사가 비활성화됨
Select Case Model=케이스 모델 선택
Select time frame=시간 간격 선택
Share count %s with %s cache only and %s encrypted=공유 개수: %s개 중 캐시 전용 %s개, 암호화 %s개
Shares Information=공유 정보
Show details=자세한 정보 보이기
Show Information=정보 보기
Shutdown the system=시스템 종료
SMART error=개 장치에서 SMART 오류 발생
SMART health-check failed=SMART 상태 점검 실패함
SMART=SMART
sn=s/n
Start the array=어레이 시작
Started only=시작된 것만
Stop the array=어레이 정지
Temp=온도
This may leave an unknown state=알 수 없는 상태가 될 수 있습니다
This will put the system to sleep=시스템을 절전 모드로 전환할 것입니다
This will reboot the system=시스템을 다시 시작 할 것입니다
This will shutdown the system=시스템을 종료 할 것입니다
This will start the array=어레이를 시작할 것입니다
This will stop the array=어레이를 정지할 것입니다
Transmit counters=송신 카운터
Transmitted packets=송신된 패킷
Unassigned Devices=할당되지 않은 장치
Unlock sortable items=정렬 가능한 항목 잠금 해제
UPS Load=UPS 부하
UPS Model=UPS 모델
UPS status=UPS 상태
Usable size=사용 가능한 용량
User count %s with %s unprotected=사용자 수: %s명, 보호되지 않음: %s명
Users Information=사용자 정보
utilization warning=사용량 경고
View Running Processes=실행중인 프로세스 보기
Virtual Machines=가상 머신
VPN Connections=VPN 연결
Warnings=경고
ZFS=ZFS

; Note: July 9, 2023 - 4 missing translations
Parity Information=
ShowHide All Content=Show/Hide All Content
ShowHide Content=Show/Hide Content
Tile Management=
