Access Mode=접근 모드
Add another Path, Port, Variable, Label or Device=다른 경로, 포트, 변수, 라벨, 장치 추가
Add Configuration=설정 추가
Add=추가
Additional Requirements=추가 요구 사항
Always=항상
App to Host=앱에서 호스트로
Application=앱
apply update=업데이트 적용
Are you sure=확실합니까
Array must be Started to view Docker containers=Docker 컨테이너를 보기 위해서는 어레이가 **시작**되어야 합니다
Autostart=자동 시작
Back=뒤로
Backup=백업
Beta=베타
Books=책
By=By
Categories=카테고리
Check for Updates=업데이트 확인
Cloud=클라우드
Config Type=설정 종류
Configuration not found=설정을 찾지 못함
Connection Type=연결 종류
Console shell command=콘솔 쉘 명령
Container ID=컨테이너 ID
Container Path=컨테이너 경로
Container Port=컨테이너 포트
Container Size=컨테이너 용량
Container=컨테이너
CPU Memory load=CPU 메모리 부하
CPU Pinning=CPU 고정 중
Created=생성됨
Crypto Currency=암호 화폐
Default Value=기본 값
Device=장치
Display=표시
DNS=DNS
Docker Containers=Docker 컨테이너
Docker Hub URL=Docker Hub URL
Docker Service failed to start=Docker 서비스 시작에 실패했습니다
Downloaders=다운로더
Drivers=드라이버
Edit Configuration=설정 편집
Exited=종료됨
Extra Parameters=추가 매개변수
Fixed IP address=고정 IP 주소
force update=강제 업데이트
FTP=FTP
Game Servers=게임 서버
healthy=정상
Hide Buttons=버튼 숨기기
Hide docker allocations=Docker 할당 숨기기
Hide more settings=추가 설정 숨기기
Home Automation=홈 자동화
Host Path=호스트 경로
Host Port=호스트 포트
HT=HT
Icon URL=아이콘 URL
Image ID=이미지 ID
Key=키
Label=라벨
LAN IPPort=LAN IP:Port
Lock sortable items=정렬 가능한 항목 잠금
Management=관리
MediaApp=미디어 앱
MediaServer=미디어 서버
Messenger=메신저
Missing parameters=매개변수 없음
Music=음악
Network Type=네트워크 종류
No Docker containers installed=설치된 Docker 컨테이너 없음
None Listed=목록에 없음
of=중
orphan image=불필요 이미지
Other=그 외
Overview=개요
Path=경로
Pause All=모두 일시정지
Photos=사진
Port Mappings=포트 매핑
Port=포트
Post Arguments=추가 인수
Privileged=권한 상승
Productivity=생산성
Project Page=프로젝트 페이지
Proxy=프록시
Pulling image=이미지 가져오는 중
Read Me First=먼저 읽어주세요
Read Only - Shared=읽기 전용 - 공유됨
Read Only - Slave=읽기 전용 - 종속
Read Only=읽기 전용
ReadWrite - Shared=읽기/쓰기 - 공유됨
ReadWrite - Slave=읽기/쓰기 - 종속
rebuild ready=재구성 준비
rebuilding=재구성 중
Remove template=템플릿 삭제
Removing container=컨테이너 삭제 중
Removing orphan image=불필요 이미지 삭제 중
Repository=저장소
Required=필수
Reset sorting=정렬 초기화
Resume All=모두 재개
Save=저장
Select a template=템플릿 선택
Select categories=카테고리 선택
Show docker allocations=Docker 할당 보이기
Show more settings=추가 설정 보이기
Stable=안정
Start All=모두 시작
starting up containers=컨테이너 시작하는 중
Stop All=모두 정지
Stopping container=컨테이너 정지 중
Successfully removed container=성공적으로 컨테이너를 삭제함
Successfully removed orphan image=성공적으로 불필요 이미지를 삭제함
Successfully stopped container=성공적으로 컨테이너를 정지함
Support Thread=지원 스레드
Template URL=템플릿 URL
Template=템플릿
The command failed=명령이 실패했습니다
The command finished successfully=명령이 성공적으로 끝났습니다
TOTAL DATA PULLED=총 받은 데이터
Total size=총 용량
Unknown action=알 수 없는 액션
Unlock sortable items=정렬 가능한 항목 잠금 해제
Update All=모두 업데이트
update ready=업데이트 준비됨
Value=값
Variable=변수
Video=비디오
Voip=VoIP
Volume Mappings=볼륨 매핑
wait=대기
Was this container created using this plugin=이 플러그인을 사용하여 이 컨테이너를 생성했습니까?
Web=웹
WebUI=웹 UI
Writable=쓰기 가능

; Note: April 21, 2025 - 23 missing translations
3rd Party=
Addresses=
available=
Compose=
Container IP=
Container not found Try reloading this page to fix=Container not found. Try reloading this page to fix.
Container not running=
DERP Relay=
Error gathering Tailscale information from container=
Exit Node=
Expired RenewDisable key expiry=Expired! Renew/Disable key expiry!
For security reasons, containers with Network Type Host should not have Tailscale enabled Please disable Tailscale in this container or change the Network Type of the container=For security reasons, containers with Network Type "Host" should not have Tailscale enabled. Please disable Tailscale in this container or change the Network Type of the container.
Hostname=
Is Exit Node=
Key Expiry=
Online=
Please check the logs and refresh the page=
Please check the logs=
Real Hostname=
Routes=
Tailscale=
update available=
URL=
