also remove image=이미지도 제거
Apply=적용
Are you sure=확실합니까?
Cancel=취소
checking=검사 중
Completely REMOVE=완전히 제거
Console=콘솔
day=일
days=일
disk image and definition=디스크 이미지 및 정의
Disks=디스크
Donate=
Done=완료
Edit=편집
Execution error=실행 오류
Force Stop=강제 정지
Hibernate=최대 절전
Log for=다음 로그:
log=로그
Logs=로그
More Info=더 많은 정보
No=아니오
OK=예
Ok=예
Pause=일시정지
Proceed=진행
Project Page=프로젝트 페이지
Read Me First=
Remove container=컨테이너 제거
Remove definition=정의 제거
Remove image=이미지 제거
Remove VM=VM 제거
Remove VM & Disks=VM 및 디스크 제거
Remove=제거
Restart=재시작
Resume=재개
Start=시작
Stop=정지
Sleep=절전
Support=지원
Update container=컨테이너 업데이트
Update=업데이트
Updating all Containers=모든 컨테이너 업데이트 중
Updating the container=컨테이너 업데이트 중
VNC Remote=VNC 리모트
WebUI=웹 UI
Yes, delete it=네, 지우세요!
Yes, update it=네, 업데이트 하세요!
Yes=네

; footer messages
Array Starting=어레이 시작 중
Array Stopping=어레이 중지 중
Mounting disks=디스크들 마운트 중
Spinning up all drives=모든 장치 스핀 업 중
Starting services=서비스 시작 중
Stopping services=서비스 중지 중
Unmounting disks=디스크들 언마운트 중 
Autostart disabled=자동 시작 비활성화됨
Missing encryption key=암호화 키 사라짐
Opening encrypted volumes=암호화된 볼륨 여는 중

; docker variables
Container Path=컨테이너 경로
Container Port=컨테이너 포트
Container Variable=컨테이너 변수
Container Label=컨테이너 라벨
Container Device=컨테이너 장치

; Note: November 16, 2021 - 2 missing translations
