A format is NEVER part of a data recovery or disk rebuild process and if done in such circumstances will normally lead to loss of all data on the disks being formatted=포맷은 **절대로** 데이터 복구나 디스크 재구성의 절차가 **아니며** 이런 경우에 진행할 경우 일반적으로 포맷된 디스크의 모든 데이터 손실로 이어집니다
Aborted=취소됨
Action=동작
Add=추가
Add Pool=풀 추가
All existing data on this device will be OVERWRITTEN when array is Started=이 장치의 기존 데이터는 어레이가 시작될 때 덮어쓰게 됩니다
Array Devices=어레이 장치
Array of %s devices=%s개 장치의 어레이가 존재함
Array Operation=어레이 동작
Attribute Name=속성 이름
Attributes=속성
auto=자동
Balance Status=밸런스 상태
Balance=밸런스
Blacklisted=블랙리스트됨
Boot Device=부트 장치
Boot system in UEFI mode=부트 시스템이 UEFI 모드입니다
btrfs balance status=btrfs 밸런스 상태
btrfs check status=btrfs 검사 상태
btrfs filesystem df=btrfs 파일 시스템 df
BTRFS operation is running=BTRFS 작업이 진행 중
btrfs scrub status=btrfs 스크럽 상태
Can not read attributes=속성을 읽을 수 없음
Can not read capabilities=기능을 읽을 수 없음
Can not read identification=식별 정보를 읽을 수 없음
Canceled=취소됨
Cannot contact key-server Please check your=키 서버와 연결할 수 없습니다 다음 사항을 확인하세요
Capabilities=기능
Check Filesystem Status=파일 시스템 상태 검사
Clear Stats=통계 지우기
Clearing in progress=지우기 진행 중
Click on FLASH above this message=이 메시지 위의 **플래시**를 클릭하세요
Click to spin down device=클릭해서 장치 스핀 다운
Click to spin up device=클릭해서 장치 스핀 업
Comments=설명
complete=완료
completed=완료됨
Completed without error=오류 없이 완료됨
Configuration valid=설정 유효
Convert to raid0 mode=raid0 모드로 변환
Convert to raid1 mode=raid1 모드로 변환
Convert to raid10 mode=raid10 모드로 변환
Convert to raid1c3 mode=raid1c3 모드로 변환
Convert to raid1c4 mode=raid1c4 모드로 변환
Convert to raid5 mode see help=raid5 모드로 변환 *도움말을 보세요
Convert to raid6 mode see help=raid6 모드로 변환 *도움말을 보세요
Convert to single mode=싱글 모드로 변환
Copying=복사 중
corrected=수정됨
Create an empty file system on the disks shown as Unmountable discarding all data currently on the disks and update parity to reflect this=마운트 할 수 없는 것으로 표시된 디스크에 새 빈 파일 시스템을 만들어 현재 디스크에 있는 모든 데이터를 삭제하고, 반영하기 위해 패리티를 업데이트 함
Creating Flash backup=플래시 백업 만들기
creating Flash backup zip file this may take several minutes=플래시 백업 zip 파일을 만드는 중 (몇 분이 걸릴 수도 있음)
Creation error=생성 오류
Critical disk temperature threshold=치명적인 디스크 온도 한계
Critical disk utilization threshold=치명적인 디스크 사용 한계
Current operation %s on %s=현재 작업 %s. (작업 일자:**%s**)
Current position=현재 위치
Custom attributes use comma to separate numbers=사용자 지정 속성 (숫자을 쉼표로 구분)
Data-Rebuild in progress=데이터 재구축 진행 중
Date of purchase=구입 날짜
Date=날짜
Delete Pool=풀 지우기
detected=감지됨
Device encrypted and unlocked=장치가 암호화되었고 잠금 해제됨
Device encrypted=장치가 암호화됨
Device is part of a pool=장치는 풀의 일부입니다
Device locked unknown error=장치 잠김: 알 수 없는 오류
Device locked wrong encryption key=장치 잠김: 잘못된 암호 키
Device to be encrypted=암호화 될 장치
Disable Spin down delay to run a SMART extended self-test=Disable **Spin down delay** to run a SMART extended self-test
Disk in parity slot is not biggest=패리티 슬롯에 있는 디스크가 가장 크지 않습니다
Disk Log Information=디스크 로그 정보
Disk-Clear in progress=디스크 지우기 진행 중
Do not use reserved names=예약된 이름을 쓰지 마세요
Do not use user share names=사용자 공유 이름을 쓰지 마세요
Download SMART report=SMART 보고서 다운로드
Dual parity valid requires ALL disks in their original slots=*듀얼 패리티*가 유효하려면 **모든** 디스크가 원 슬롯에 있어야합니다
Elapsed time=소요된 시간
Enable user share assignment=사용자 공유 지정 활성화
enter disk index and device name as applicable to your controller=컨트롤러에 맞는 디스크 인덱스와 장치 이름을 입력하세요
Erase Device Content=장치 콘텐츠 지우기
encrypted=암호화됨
Encryption input=암호화 입력
Encryption status=암호화 상태
Enter new key=새 키 입력
Errors occurred - Check SMART report=오류 발생 - SMART 보고서를 확인하세요
Estimated finish=예상된 완료
Estimated speed=추정 속도
Existing content is permanently lost=기존 콘텐츠는 영구히 사라집니다
Failed=실패
Feature=기능
File system status=파일 시스템 상태
File system type=파일 시스템 종류
Finding %s error=**%s**개의 오류가 발견됨
Finding %s errors=**%s**개의 오류가 발견됨
Flag=플래그
Flash backup=플래시 백업
Flash device is set as public share=플래시 장치가 공개 공유로 설정되어 있습니다
Flash Device Settings=플래시 장치 설정
Format Unmountable disks=마운트 할 수 없는 디스크 포맷
Formatting=포맷 중
formatting=포맷 중
Free=여유
FS=FS
Global Configuration=전역 설정
Hide=숨기기
Identification=식별자
Identity=식별
if checked, Start array but do not mount disks=체크되었을 경우, 어레이를 시작하나 디스크들을 마운트 하지 않습니다
If this is a new array, move the largest disk into the parity slot=새 어레이인 경우 가장 큰 디스크를 *패리티* 슬롯으로 이동합니다
If you are adding a new disk or replacing a disabled disk, try Parity-Swap=새 디스크를 추가하는 중이거나 비활성화 된 디스크를 교체하는 경우, 패리티 스왑을 시도하세요
Information=정보
Insufficient free disk space available=디스크에 여유 공간이 부족합니다
Interrupted=인터럽트됨
Invalid configuration=유효하지 않은 설정
invalid device=
invalid devices=
Invalid expansion=유효하지 않은 확장
Invalid pool name=유효하지 않은 풀 이름
Invalid, missing or expired=유효하지 않거나 누락되었거나 만료됨
is only available when array is Started in Maintenance mode=은(는) 어레이가 **유지보수 모드**로 시작되었을 때 사용 가능합니다
is only available when array is Started=은(는) 어레이가 시작되었을 때 사용 가능합니다
Keyfile=키 파일
Last check completed on %s=마지막 검사가 **%s**에 완료됨
Last check incomplete on %s=마지막 검사가 **%s**에 완료되지 않음
Last checked on %s=마지막 검사는 **%s**
Last SMART test result=마지막 SMART 검사 결과
Maintenance mode=유지보수 모드
Maintenance Mode=유지보수 모드
Maintenance=유지보수
Manufacturing date=생산 일자
Menu View=메뉴 보기
Minimum free space=최소 여유 공간
Missing Cache disk=캐시 디스크 누락됨
Missing disk=디스크 누락됨
Missing key=키 누락됨
Missing=누락됨
Mounted=마운트됨
Mover is running=무버가 실행 중입니다
network settings=네트워크 설정
next device=다음 장치
New data disks detected=새 데이터 디스크가 감지되었습니다
No array data disks have been assigned=어레이 디스크가 지정되지 않았습니다
No data disks=데이터 디스크가 없습니다
No parity check history present=패리티 검사 기록이 없습니다
No self-tests logged on this disk=이 디스크에 자가 검사 로그가 없습니다
Not installed=설치되지 않음
OK=OK
Once copy completes, the array may be Started, to initiate Data-Rebuild of the disabled disk=복사가 완료되면, 비활성화된 디스크의 데이터 재구성을 시작하기 위해 어레이를 시작할 수 있습니다
operation=작업
Options see Help=옵션 (도움말을 보세요)
Otherwise use the keyfile method for UTF8 input=그 외엔 UTF-8 입력에 **키 파일** 방식을 이용하세요
Parity disks content will be overwritten=**패리티** 디스크의 내용이 덮어쓰게 됩니다
Parity is already valid=패리티는 이미 유효합니다
Parity operation is running=패리티 작업이 진행중입니다
Parity valid requires ALL disks to have their original content=**유효한 패리티**는 **모든** 디스크의 원본 콘텐츠를 필요로합니다
Parity-Check in progress=패리티 검사 진행 중
Parity Operation History=패리티 작업 이력
ParityRead-Check History=패리티/읽기 검사 기록
Parity-SyncData-Rebuild in progress=패리티 동기화/데이터 재구성 진행 중
Parity-Sync in progress=패리티 동기화 진행 중
Partition format=파티션 포맷
Partition size=파티션 용량
Passed=통과됨
Passphrase=암호
Perform full balance=풀 밸런스 실행
Permit UEFI boot mode=UEFI 부트 모드 허용
Please change share SMB security=SMB 공유 보안 설정을 변경해 주세요
Please check your system settings to support UEFI boot mode=시스템 설정이 UEFI 부트 모드를 지원하는지 확인하세요
Pool Devices=풀 장치
Pool name already exists=풀 이름이 이미 있습니다
Pool of %s devices=%s개 장치의 풀
Preclear in progress=사전 지우기 진행 중
previous device=이전 장치
Printable Characters Only=출력 가능한 문자만
Proceed to start=시작하기
Raw Value=원시 값
Raw View=원시 뷰
Read-Check in progress=읽기 검사 진행 중
Reading=
Reboot in safe mode=안전 모드로 다시 시작
registration key=등록 키
Registration Key Manager=등록 키 관리자
reiserfsck status=reiserfsck 상태
Rename Pool=풀 이름 변경
Repair corrupted blocks=손상된 블록 복구
Replacement disk installed=교체 디스크 설치됨
Replacement disk is too small=교체 디스크가 너무 작습니다
Retype passphrase=암호 재입력
Schedule=일정 설정
Scrub Status=스크럽 상태
Scrub=스크럽
See %s Settings=%s 설정 보기
self-test in progress=자가 검사 진행 중
Self-Test=자가 검사
Server boot mode=서버 부트 모드
Set default boot menu=기본 부트 메뉴 설정
show passphrase=암호 보이기
Show=보기
Slots=슬롯
SMART attribute notifications=SMART 속성 알림
SMART controller type=SMART 컨트롤러 종류
SMART error log=SMART 오류 로그
SMART extended self-test=SMART 확장 자가 검사
SMART health-check failed=SMART 상태 검사 실패
SMART notification tolerance level=SMART 알림 허용 범위
SMART notification value=SMART 알림 값
SMART self-test history=SMART 자가 검사 기록
SMART self-test in progress=SMART 자가진단 진행중
SMART Settings=SMART 설정
SMART short self-test=SMART 짧은 자가 검사
SMART status=SMART 상태
Speed=속도
Spin down delay=스핀 다운 딜레이
Spin Down=스핀 다운
Spin Up=스핀 업
Spinup groups=스핀 업 그룹
Started, array protected=시작됨, 어레이 보호됨
Started, array unprotected=시작됨, 어레이 미보호
Started, clearing=
Started, formatting=시작됨, 포맷 중
Starting, copying=
Starting=시작하는 중
Stopping=정지하는 중
Sync errors=동기화 오류
Sync errors corrected=
Sync errors detected=
Sync=동기화
Syslinux Configuration=Syslinux 설정
Syslinux configuration=Syslinux 설정
Temp=온도
The array will be immediately available, but unprotected since parity has not been assigned=어레이는 즉시 사용 가능할 것이나, *패리티*가 지정되지 않아 **미보호**됩니다
The array will be immediately available, but unprotected until Parity-Sync completes=어레이는 즉시 사용 가능할 것이나, 패리티 동기화가 완료될 때 까지 **미보호**됩니다
The replacement disk must be as big or bigger than the original=교체 디스크는 원본의 크기거나 그 보다 커야합니다
This is typically done when a new disk is added to the array to get it ready for files to be written to it=이것은 보통 새 디스크가 어레이에 추가되고 파일 쓰기가 준비되는 동안 완료됩니다
This Unraid OS release has been withdrawn and may no longer be used Please=이 Unraid OS 릴리즈는 철회되었으며 사용해서는 안됩니다
This will ERASE ALL device content=모든 장치의 콘텐츠를 지웁니다
This will ERASE content of ALL devices in the pool=풀에 있는 모든 장치의 콘텐츠를 지웁니다
This will reboot the system=시스템을 다시 시작합니다
This will shutdown the system=시스템을 종료합니다
This will stop the array=어레이를 정지합니다
This will stop the running operation=진행중인 작업을 정지합니다
Threshold=한계
Title=제목
To confirm your action type %s=작업 유형 %s을(를) 확인하려면
Toggle readswrites display=읽기/쓰기 표시 전환
Too many attached devices Please consider upgrading your=너무 많은 장치가 장착되었습니다. 업그레이드를 고려해 주세요.
Too many wrong andor missing disks=잘못된 혹은 사라진 디스크가 너무 많습니다
Total size=전체 용량
Unassign ALL devices to delete this pool=이 풀을 삭제하기 위해서 **모든** 장치를 할당 해제하세요
Unassigned Devices=할당되지 않은 장치
unavailable no parity-check entries logged=사용 불가 (패리티 검사 로그가 없음)
Unavailable - disk must be spun up=사용 불가 - 디스크가 스핀 업 되어야 함
Unavailable=사용 불가
Unclean shutdown detected=불완전한 종료가 감지됨
Unmountable disk present=마운트 할 수 없는 디스크 존재
Unmountable disks present=마운트 할 수 없는 디스크 존재
Unmountable Encrypted volume present=마운트 할 수 없음: 암호화된 볼륨이 존재 함
Unmountable Missing encryption key=마운트 할 수 없음: 암호화 키 사라짐
Unmountable No file system=마운트 할 수 없음: 파일 시스템이 없음
Unmountable No pool uuid=마운트 할 수 없음: 풀 uuid가 없음
Unmountable not btrfs pool=마운트 할 수 없음: btrfs 풀이 아님
Unmountable Unsupported or no file system=Unmountable: Unsupported or no file system
Unmountable Volume not encrypted=마운트 할 수 없음: 볼륨이 암호화되지 않음
Unmounted=마운트 되지 않음
Upgrading diskswapping parity=디스크/스왑핑 패리티 업그레이드 중
Use ASCII characters from space to tilde=공백 문자부터 물결표까지의 **ASCII** 문자를 사용하세요
Use Default=기본값 사용
Use default=기본값 사용
Use only lowercase with no special characters or leadingtrailing digits=특수 문자와 처음과 끝 부분에 숫자를 제외한 영문 소문자만 사용하세요
use printable characters only=출력 가능한 문자만 사용
Used=사용됨
Value=값
WARNING canceling may leave the array unprotected=경고: 취소하는 경우 어레이가 미보호 상태가 될 수 있습니다
Warning disk temperature threshold=경고 디스크 온도 한계
Warning disk utilization threshold=경고 디스크 사용량 한계
WARNING=경고
Warranty period=보증 기간
will activate a clean system power down=시스템을 완전히 종료합니다
will activate a clean system reset=시스템을 완전히 재가동합니다
will bring the array on-line and start Clearing new data disks=어레이를 온라인으로 전환하고 새 데이터 디스크을 **지웁**니다
will bring the array on-line and start Data-Rebuild=will bring the array on-line and start **Data-Rebuild**
will bring the array on-line and start Disk-Clear of new data disks=will bring the array on-line and start **Disk-Clear** of new data disk(s)
will bring the array on-line and start Parity-Check=어레이를 온라인으로 전환하고 **패리티 검사**를 시작합니다
will bring the array on-line and start Parity-Sync=will bring the array on-line and start **Parity-Sync**
will bring the array on-line and start Parity-Sync andor Data-Rebuild=어레이를 온라인으로 전환하고 **패리티 동기화** 그리고/혹은 **데이터 재구성**을 시작합니다
will bring the array on-line=어레이를 온라인으로 전환합니다
will copy the parity information to the new parity disk=패리티 정보를 새 패리티 디스크로 복사합니다
will create a file system in all Unmountable disks=모든 마운트 할 수 없는 디스크에 파일 시스템을 만듭니다
will delete the encryption keyfile=암호화 키 파일을 삭제합니다
will disable the missing disk and then bring the array on-line Install a replacement disk as soon as possible=사라진 디스크를 비활성화하고 어레이를 온라인으로 전환합니다. 최대한 빠르게 교체 디스크를 설치하세요
will expand the file system of the data disk if possible then bring the array on-line and start Data-Rebuild=데이터 디스크의 파일 시스템을 확장합니다; 가능한 경우 어레이를 온라인으로 전환하고 데이터 재구성을 시작합니다
will immediately clear all disk statistics=즉시 모든 디스크의 통계를 삭제합니다
will immediately invoke the Mover=즉시 무버를 작동시킵니다
will immediately spin down all disks=즉시 모든 디스크를 스핀 다운 합니다
will immediately spin up all disks=즉시 모든 디스크를 스핀 업 합니다
will pause the Clearing=지우기를 일시정지합니다
will pause the Parity-Check=패리티 검사를 일시정지합니다
will pause the Parity-SyncData-Rebuild=패리티 동기화/데이터 재구성을 일시정지합니다
will pause the Read-Check=읽기 검사를 일시정지합니다
will pause Data-Rebuild=데이터 재구축을 일시 중지합니다
will pause Disk-Clear=디스크 지우기를 일시 중지합니다
will pause Parity-Check=패리티 검사를 일시 중지합니다
will pause Parity-Sync=패리티 동기화를 일시 중지합니다
will pause Read-Check=읽기 검사를 일시정지합니다
will record all disk information and bring the array on-line=모든 디스크의 정보를 기록하고 어레이를 온라인으로 전환합니다
will record all disk information, bring the array on-line, and start Parity-Sync=모든 디스크의 정보를 기록하고, 어레이를 온라인으로 전환 한 후에, 패리티 동기화을 시작합니다
will remove the missing cache disk and then bring the array on-line=사라진 캐시 디시크를 삭제하고 어레이를 온라인으로 전환합니다
will resume the paused Clearing=일시정지된 지우기를 다시 진행합니다
will resume the paused Parity-Check=일시정지된 패리티 검사를 다시 진행합니다
will resume the paused Parity-SyncData-Rebuild=일시정지된 패리티 동기화/데이터 재구성을 다시 진행합니다
will resume the paused Read-Check=일시정지된 읽기 검사를 다시 진행합니다
will resume Data-Rebuild=데이터 재구축을 재개합니다
will resume Disk-Clear=디스크 지우기를 재개합니다
will resume Parity-Check=패리티 검사를 재개합니다
will resume Parity-Sync=패리티 동기화를 재개합니다
will resume Read-Check=읽기 검사를 재개합니다
will start Clearing new data disks=새 디스크을 **지우기** 시작합니다
will start Parity-Sync andor Data-Rebuild=즉시 **패리티 동기화** 그리고/혹은 **데이터 재구성**을 시작합니다
will start Disk-Clear of new data disks=새 데이터 디스크의 **디스크 지우기**를 시작합니다
will start Parity-Check=**패리티 검사**를 시작합니다
will start Data-Rebuild=**데이터 재구축**을 시작합니다
will start Parity-Sync=**패리티 동기화**를 시작합니다
will start Read-Check of all array disks=모든 어레이 디스크의 **읽기 검사**를 시작합니다
will stop Parity-SyncData-Rebuild=패리티 동기화/데이터 재구성을 정지합니다
will stop the Parity-Check=패리티 검사를 정지합니다
will stop the Read-Check=읽기 검사를 정지합니다
will stop Clearing=지우기를 정지합니다
will stop Disk-Clear=디스크 지우기를 정지합니다
will stop Data-Rebuild=데이터 재구축을 정지합니다
will stop Parity-Check=패리티 검사를 정지합니다
will stop Parity-Sync=패리티 동기화를 정지합니다
will stop Read-Check=읽기 검사를 정지합니다
will take the array off-line=어레이를 오프라인으로 전환합니다
Worst=최악
Write corrections to parity=수정된 내용을 패리티에 쓰기
Writes=쓰기
Wrong key=잘못된 키
xfs_repair status=xfs_repair 상태
You may not add new disks and also remove existing disks=새 디스크를 추가하거나 기존 디스크를 제거하지 마세요
your server=서버

; Sleep plugin translations
Check this=자세한 내용은 이
for more information=을 확인하십시오
Make sure your server supports S3 sleep=서버가 S3 절전 모드를 지원하는지 확인하십시오
Sleep will immediately put the server in sleep mode=**절전(Sleep)** 서버를 즉시 절전 모드로 전환합니다
Sleeping=절전 모드로 전환 중
System in sleep mode=시스템이 절전 모드 상태임
This will put the system in sleep mode=시스템을 절전 모드로 전환합니다
wiki entry=위키 항목

; Note: May 7, 2022 - 27 missing translations
