%s An update is available=%s에 대한 업데이트가 있습니다.
Alert Message=경고 메시지
anonymous=익명
Author=제작자
Check For Updates=업데이트 확인
Checking connectivity=연결 상태 확인 중
checking=확인 중
Click here to install version %s=여기를 눌러 %s 버전을 설치하세요.
Delete Plugin=플러그인 제거
DOWNGRADE TO VERSION=다음 버전으로 다운그레이드:
Enter URL of remote plugin file or local plugin file=원격 플러그인 파일이나 로컬 플러그인 파일의 URL 입력
ERROR=오류
Install Plugin=플러그인 설치
Install=설치
install=설치
Installed Plugins=설치된 플러그인
Installing Update=업데이트 설치 중
need check=검사 필요
Next=다음
No plugins installed=플러그인이 설치되지 않음
No release notes available=사용 가능한 릴리즈 노트 없음
No response, aborting=응답 없음, 취소 중
Plugin File Install Errors=플러그인 파일 설치 오류
Plugin File=플러그인 파일
Plugin History=플러그인 기록
Plugin Update Check=플러그인 업데이트 검사
Plugin=플러그인
Release Notes=릴리즈 노트
Remove Plugin=플러그인 제거
Remove Selected Plugins=선택된 플러그인 제거
remove=제거
Select local plugin file=로컬 플러그인 파일 선택
Stable=안정
STALE=부실
Support Thread=지원 스레드
Uninstall=제거
Update All Plugins=모든 플러그인 업데이트
Update Plugin=플러그인 업데이트
Upgrade=업그레이드
View Release Notes=릴리즈 노트 보기

; Note: April 28, 2023 - 1 missing translations
Update Incompatible=
