Add Share=공유 추가
All files encrypted=모든 파일들 암호화됨
All files protected=모든 파일들 보호됨
All files unprotected=모든 파일들 비보호됨
Allocation method=할당 방법
Array must be Started to view Shares=공유를 보기 위해서는 반드시 어레이가 **시작**되어 합니다
Automatically split any directory as required=자동으로 필요한 만큼 아무 디렉토리를 나누기
Automatically split only the top five directory levels as required=자동으로 필요한 만큼 상위 다섯개 디렉토리 단계만 나누기
Automatically split only the top four directory levels as required=자동으로 필요한 만큼 상위 네개 디렉토리 단계만 나누기
Automatically split only the top level directory as required=자동으로 필요한 만큼 상위 디렉토리 단계만 나누기
Automatically split only the top three directory levels as required=자동으로 필요한 만큼 상위 세개 디렉토리 단계만 나누기
Automatically split only the top two directory levels as required=자동으로 필요한 만큼 상위 두개 디렉토리 단계만 나누기
Comments=코멘트
Compute All=모두 계산
Compute=계산
Disk Shares=디스크 공유들
Do not use reserved names=예약된 이름들을 사용하지 마세요
Do not use pool names=풀 이름들을 사용하지 마세요
Enable Copy-on-write=Copy-on-write 활성화
Enter a name for the share=공유 이름을 입력하세요
Excluded disks=제외된 디스크
Export=내보내기
Fill-up=Fill-up
Free=여유
has been deleted=가 삭제되었습니다
HDD=HDD
High-water=High-water
Included disks=포함된 디스크
Invalid Characters=유효하지 않은 문자들
Invalid share name=유효하지 않은 공유 이름
Manual do not automatically split directories=수동: 자동으로 디렉토리를 나누지 않음
Minimum free space=최소 여유 공간
Missing share name=공유 이름 없음
Most-free=Most-free
Mover takes no action=무버가 아무 행동도 하지 않음
Mover transfers files from array to cache=무버가 어레이에서 캐시로 파일을 전송함
Mover transfers files from cache to array=무버가 캐시에서 어레이로 파일을 전송함
next user share=다음 유저 공유
Only=전용
Prefer=선호
previous user share=아전 유저 공유
Read=읽기
Recompute=재계산
Rule=규칙
Select cache pool=캐시 풀 선택
Set when adding new share only=새 공유를 추가할 때만 설정 가능
Share contains data=공유가 데이터를 포함
Share is empty=공유가 비어 있음
Share is outside the list of designated disks=공유가 지정된 디스크들 밖에 있음
Share Settings=공유 설정들
Share status=공유 상태
Size=용량
Some or all files unencrypted=일부 혹은 모든 파일들이 비암호화됨
Some or all files unprotected=일부 혹은 모든 파일들이 비보호됨
Split level=분할 레벨
SSD=SSD
There are no exportable disk shares=내보내기 가능한 디스크 공유 없음
There are no exportable user shares=내보내기 가능한 유저 공유 없음
Time Machine volume size limit=Time Machine 볼륨 용량 제한
Unknown encryption state=암호화 상태 알 수 없음
Use cache pool for new filesdirectories=캐시 풀 사용 (새 파일/디렉토리에)
User Shares=유저 공유들
Write=쓰기
You cannot use the following within share names=공유 이름에 다음을 사용할 수 없습니다
