Add ISO File Share=추가: ISO 파일 공유
Add Remote SMB=추가: 원격 SMB
Add Root Share=추가: 루트 공유 
An XFS, BTRFS, or ZFS disk partitioned in UD is compatible with the array disk partitioning and can be added to the array=UD에서 분할된 XFS, BTRFS 또는 ZFS 디스크는 어레이 디스크 분할과 호환되며 어레이에 추가할 수 있습니다
Any data on this disk will be lost=본 디스크의 모든 데이터가 손실됩니다
Are you sure=확실합니까
Auto mount=자동 마운트
Back=뒤로
Browse Disk Share=찾아보기: 디스크 공유
Browse ISO File Share=찾아보기: ISO 파일 공유
Browse Remote SMB=찾아보기: 원격 SMB
Choose File System Format=파일 시스템 형식 선택
Choose ISO File=ISO File 선택
Choose Server=서버 선택
Choose Share=공유 선택
Click on Icon to Choose Protocol=아이콘을 클릭하여 프로토콜 선택
Change Disk Mount Point=디스크 마운트 지점 변경
Change ISO File Mount Point=ISO 파일 마운트 지점 변경
Change Remote Share Mount Point=원격 공유 마운트 지점 변경
Change SMB=SMB
Changing the Mount Point will also change the disk label=마운트 지점을 변경하면 디스크 레이블도 변경됩니다
Clear=지우기
Clear Disk=다음의 디스크을 지울까요:
Click to select ISO file=ISO 파일을 선택하려면 클릭하세요
Click to view/hide partitions and mount points=파티션 및 마운트 지점을 보거나 숨기려면 클릭하세요
Complete=완료
Device=장치
Disks=디스크
Disk Label=디스크 레이블
Disk Log Information=디스크 로그 정보
Data on this disk will be lost=본 디스크의 데이터가 손실됩니다
Disk Sharing must be disabled to add a Root Share=루트 공유를 추가하려면 디스크 공유를 비활성화해야 합니다
Do NOT use a remote share local mount in a Docker container or VM for critical data=중요한 데이터에 대해 Docker 컨테이너 또는 VM에서 원격 공유 로컬 마운트를 사용하지 마십시오
Do not put files or folders into the /mnt/rootshare/ folder=파일이나 폴더를 /mnt/rootshare/ 폴더에 넣지 마십시오
Domain=도메인
Edit Device Script=장치 스크립트 편집
Edit ISO File Script=ISO 파일 스크립트 편집
Edit Remote SMB=원격 SMB
Enter the Domain for the share if on a Domain=도메인에 있는 경우 공유에 대한 도메인을 입력하세요
Enter the Password if the share is password protected=공유가 암호로 보호되어 있는 경우 암호를 입력하세요
Enter the Username if the share is password protected=공유가 암호로 보호된 경우 사용자 이름을 입력하세요
Enter the password to use for this disk=이 디스크를 사용하려면 비밀번호를 입력하세요
Execute Script as udev simulating a device being installed=설치 중인 장치를 시뮬레이션하는 udev로 스크립트 실행
Fail=실패
file share for=다음에서 파일 공유
File System Check=파일 시스템 검사
File System Scrub=파일 시스템 스크럽
Format=포맷
Formatting=포맷 중
Free=여유
from disk=디스크에서
Go to Settings->Global Share Settings and set Enable Disk Shares to Auto or Off=설정 -> 전역 공유 설정으로 이동하여 디스크 공유 활성화를 자동 또는 끄기로 설정합니다
Historical=기록
Historical Devices=기록 장치
Historical Device is=기록 장치:
Identification=식별자
If this disk was pre-cleared, you will remove the pre-clear signature=이 디스크가 사전 삭제된 경우 사전 정리 서명을 제거합니다
If you add the disk to the array and the pre-clear signature is removed, Unraid will go through the lengthy process of clearing the disk again=어레이에 디스크를 추가하고 사전 지우기 서명이 제거되면 Unraid는 디스크를 다시 지우는 긴 프로세스를 거칩니다
is offline=오프라인
ISO File is=ISO 파일:
ISO File Shares=ISO 파일 공유
If using a disk password be sure to enter the password for this disk in UD Settings so it can be mounted=디스크 암호를 사용하는 경우 마운트할 수 있도록 UD 설정에서 이 디스크의 암호를 입력해야 합니다
Device=장치
Leave blank to use the array passwordpassphrase=어레이 암호(Password/Passphrase)를 사용하려면 비워 둡니다.
Load Shares=공유 불러오기
Loading=불러오는 중
Log=로그
Mount=마운트
Mount Point=마운트 지점
Mounting=마운트 중
Next=다음
NFS Mount Point=NFS 마운트 지점 변경 
NFS or ISO File Shares configured=NFS 또는 ISO 파일 공유가 없습니다
NFS Script=NFS 스크립트 편집
NFS Script Log=NFS 스크립트 로그
NFS Share=NFS 공유
NFS Shares=NFS 공유
No Remote SMB=구성된 원격 SMB
No Unassigned Disks available=사용 가능한 '할당되지 않은 디스크'가 없습니다
not installed=설치되지 않음
Note=참고사항
offilne=오프라인
You must enable NFS in Settings->NFS to mount NFS shares=NFS 공유를 마운트하려면 설정->NFS에서 NFS를 활성화해야 합니다
You must enable SMB in Settings->SMB to mount SMB shares=SMB 공유를 마운트하려면 설정->SMB에서 SMB를 활성화해야 합니다
Open=열기
Partition and Format Disk=디스크 파티션 및 포맷
Pass Thru=패스 스루
Password=암호
Read only=읽기 전용
Reboot=다시 시작
Refresh Disks and Configuration=디스크 및 설정 새로 고침
Remember your password It cannot be recovered=비밀번호는 복구할 수 없으므로 잘 기억해 두세요 
Remote Share is=원격 공유:
Remote share mounts are dependent on a solid and reliable network connection and that is difficult to achieve=원격 공유 마운트는 견고하고 안정적인 네트워크 연결에 의존하며 보관하기 어렵습니다
Remove Device configuration=제거: 장치 구성
Remove ISO File Share=제거: ISO 파일 공유
Remove Partition=제거: 파티션
Remove Remote SMB=제거: 원격 SMB
Remove partition=제거: 파티션
Running=실행 중
Script=스크립트
Search For Servers=서버에서 검색
Search for Servers, or enter the Server nameIP address manually=서버를 검색하거나 서버 이름IP 주소를 수동으로 입력하세요
Search for Shares or enter the Share name manually=공유를 검색하거나 수동으로 공유 이름을 입력하세요
Searching=검색 중
Select the Mount Point to Root Share=루트 공유에 대한 마운트 지점 선택
Serial Number Mount Point=일련 번호(마운트 지점)
Shares=공유
Share Type=공유 유형
share for=다음에서 공유:
Simple=간편
SMB Shares=SMB 공유
Source=원본
SSD cannot be spun down=SSD는 스핀다운할 수 없습니다
Success=성공
Show Historical Devices=기록 장치 보기
Show SMB/NFS/ISO Shares=SMB/NFS/ISO 공유 보기
Show Disk Devices=디스크 장치
This is a way to gather Unraid shares into one Root Share=이것은 Unraid 공유를 하나의 루트 공유로 모으는 방법입니다
This will remove the ISO file share for=다음의 ISO 파일 공유가 제거됩니다
This will remove the remote=다음의 원격 공유가 제거됩니다
This will remove the saved configuration of=다음의 저장된 구성이 제거됩니다
This will remove the=다음의 항목이 제거됩니다
to confirm=확인
to format=라고 쓰면 포맷됩니다
to clear this disk of all partitions=라고 쓰면 본 디스크의 모든 파티션이 지워집니다
Unmount=마운트 해제
Unmounting=마운트 해제 중
Use caution when gathering shares into one Root Share=공유를 하나의 루트 공유로 수집할 때 주의하십시오
Used=사용됨
User and Pool Shares=사용자 및 풀 공유
User Shares=사용자 공유
Username=사용자 이름
View Device Script Log=장치 스크립트 로그 보기
View ISO File Script Log=ISO 파일 스크립트 로그 보기
View Remote SMB=원격 SMB 보기
WARNING=경고
When you copy files between shares in the Root Share, the files may not end up on the expected disks=루트 공유의 공유 간에 파일을 복사하면 파일이 예상 디스크에 도달하지 않을 수 있습니다
Working=작업 중
You can also subject yourself to security issues like ransomware by exposing all your shares in one Root Share=하나의 루트 공유에 모든 공유를 노출함으로 인해 랜섬웨어와 같은 보안 문제에 노출될 수도 있습니다
You must enable NFS in Settings->NFS to mount NFS shares=NFS 공유를 마운트하려면 설정->NFS에서 NFS를 활성화해야 합니다
You must enable SMB in Settings->SMB to mount SMB shares=SMB 공유를 마운트하려면 설정->SMB에서 SMB를 활성화해야 합니다
You must enable the Destructive Mode in UD Settings before you can Format this disk=이 디스크를 포맷하기 전에 UD 설정에서 파괴 모드를 활성화해야 합니다
You WILL have problems if you do=다음과 같은 문제가 발생될 수 있습니다
You will need to enter credentials to list the shares=공유를 나열하려면 자격 증명을 입력해야 합니다
ZFS Pool Name=ZFS 풀 이름

:unassigned_devices_general_help_plug:
> **Unassigned Devices is called UD for short.**
>
> Hover your mouse over an any active area on the UD page and a tool tip will show you what clicking that area does.
> You can mount USB devices, sata drives, Remote SMB/NFS shares, and ISO Files with UD.  Any devices with the auto mount switch on will be mounted when the array is started.  All drives and SMB/NFS Mounts are unmounted when the array is stopped on the 'stopping_svcs' event.
> If you want to share your drive, you can turn on the Share switch.  The default for Remote SMB shares is Public read/write access.  Enable SMB Security by user in the Unassigned Devices Settings.  NFS shares are exported and access is read/write.  The export of NFS devices is enabled in the Unassigned Devices settings. You can also enable a common script that will be executed on every disk mount.  In order to share any UD device, sharing needs to be enabled in the UD Settings and the switch turned on to share the particular device.  SMB/NFS remove shares and ISO mounts are always shared.
>
> Additional options are available when you click on the <i style='color:black;font-weight:bold;' class="fa fa-plus-square"></i> icon by device identification.  When the disk is unmounted, the mount point of the device can be changed.  The disk label will also be changed.  A disk can be formatted and an fsck run to check the disk.
>
> The 'Settings->Unassigned Devices' security settings for SMB and NFS must be set correctly for SMB and NFS sharing to work properly.
>
> If the mount button is grayed out for a SMB/NFS remote share, the remote server is not responding to a ping.  The remote share server must respond to a ping or UD will consider it off-line.
>
> UD has a destructive mode that allows deleting disk partitions and formatting disks.	If Destructive Mode is not turned on in the UD Settings, you WILL NOT be able to format a disk or remove partitions.  Go the the 'Settings->Unassigned Devices' to set the destructive mode.
>
> **To format a disk:**
>
> + Destructive mode must be enabled.
> + Disk must have all partitions removed.  Unmount disk, click on the <i style='color:black;font-weight:bold;' class='fa fa-plus-square'></i> icon,, and click on all <i style='color:red;font-weight:bold;' class='fa fa-remove hdd'></i> icons to delete partitions.
> + If the disk has been precelared and shows a grayed 'Format' button, click on the <i style='color:black;font-weight:bold;' class='fa fa-plus-square'></i> icon, then click on the <i style='color:red;font-weight:bold;' class='fa fa-remove hdd'></i> icon to delete the preclear status file.
>
> **Note: A disk partitioned in UD is compatible with the array disk partitioning and can be added to the array. Supported file formats are XFS, XFS encrypted, BTRFS and BTRFS encrypted.**
>
> **Encrypted Disks:**
>
> + Any disk formatted in UD that is encrypted will use the array password/passphrase and can be incorporated into the array.  Or you can set a unique password when it is formatted.  If you set a password on the disk when it is formatted, you will need to enter a disk password in Unassignd Devices->Settings for that disk.
> + Any disk that was not encrypted with the Array password/passphrase can be mounted by setting a per disk passord set in Unassigned Devices->Settings.
>
> **Unassigned devices script:**
>
> UD includes a script that is used for mounting and unmounting devices and SMB/NFS mounts. These scripts can be used from the command line or in your scripts as necessary.
>
> + '/usr/local/sbin/rc.unassigned mount auto' - all devices and SMB/NFS mounts set to auto mount will be mounted.
> + '/usr/local/sbin/rc.unassigned umount auto' - all devices and SMB/NFS mounts set to auto mount will be unmounted.
> + '/usr/local/sbin/rc.unassigned umount all' - all devices and SMB/NFS mounts are unmounted in preparation for shutting down the array.
> + '/usr/local/sbin/rc.unassigned mount /dev/sdX' - mount device sdX where 'X' is the device designator.
> + '/usr/local/sbin/rc.unassigned umount /dev/sdX' - unmount device sdX where 'X' is the device designator. You can use this command in a UD script to unmount the device when the script has completed.
> + '/usr/local/sbin/rc.unassigned refresh /dev/sdX' - used at the end of the 'ADD' case of a script so the 'Running...' indicator will be updated.
:end

; Note: April 11, 2023 - 7 missing translations
