Cancel=취소

; My PSAs / banners
Happy New Year=새해 복 많이 받으세요
Happy Holidays from Andrew, Tracey, and family=메리 크리스마스 - Andrew, Tracey, 그리고 그의 가족으로부터...
Please Enjoy Responsibly=책임감 있게 즐겨주세요
Popup Blocked CA requires popups to be enabled under certain circumstances You must white list your server within your browser to allow popups=팝업 차단됨: CA는 특정 상황에서 팝업을 활성화해야 합니다 팝업을 허용하려면 브라우저에서 당신의 서버를 팝업 허용 목록에 추가해야 합니다
Docker Service Not Enabled - Only Plugins Available To Be Installed Or Managed=도커 서비스가 활성화되지 않음 - 플러그인만 설치 혹은 관리 가능
Docker system failed to start - Only Plugins Available To Be Installed Or Managed=Docker 시스템 시작 실패 - 플러그인만 설치 혹은 관리 가능
Array not started - Only Plugins Available To Be Installed Or Managed=어레이가 시작되지 않음 - 플러그인만 설치 혹은 관리 가능
Community Applications works best when cookies are enabled in your browser Certain features may not be available=커뮤니티 앱은 브라우저에서 쿠키가 활성화되어 있을 때 가장 잘 작동합니다. 특정 기능을 사용하지 못할 수 있습니다.
Backup Server Active Some icons may not appear, and plugin installations may be affected=백업 서버 활동 중. 일부 아이콘이 표시되지 않을 수 있으며 플러그인 설치가 영향을 받을 수 있습니다.
Debugging enabled This significantly increases the memory used by your browser=디버깅 활성화는 브라우저에서 사용하는 메모리를 크게 증가시킵니다.
Browser translation detected Display issues may result=브라우저 번역이 감지되었습니다. 표시 문제가 발생할 수 있습니다.
Action Centre Enabled=동작 센터가 활성화되었습니다.

; Sorting Options
Sort By=다음으로 정렬:
Name Ascending=이름 오름차순
Name Descending=이름 내림차순
Downloads=다운로드순
Date Added=추가된 날짜순
Number Of Apps=앱 숫자
; Initial disclaimer translations
Disclaimer=면책 사항
All applications listed here are 3rd party additions to Unraid Neither the authors of Community Applications nor Limetech make any warranty as to the suitability of any application listed here=여기에 나열된 모든 앱은 Unraid에 대한 타사 추가 사항입니다. Community Applications의 작성자나 Limetech는 여기에 나열된 앱의 적합성에 대해 어떠한 보증도 하지 않습니다.
Every attempt is made to ensure that only safe and compatible applications are present=안전하고 호환되는 앱만 존재하도록 모든 시도가 이루어집니다.
Application Policy=앱 정책
I Understand=알겠습니다
Installations of apps disabled You must accept the warning to be able to install applications=앱 설치가 비활성화되었습니다. 앱을 설치하려면 경고에 동의해야 합니다.
Click here=여기를 클릭하세요
%s Results Per Page=페이지당 결과: %s
Results Per Page: %s=페이지당 결과: %s

; Plugin Disclaimer
Community Applications contains both docker containers and plugin applications Plugins are designed for OS enhancements, and run with full privileges on your system and are clearly identified within CA=커뮤니티 앱에는 도커 컨테이너와 플러그인 앱이 모두 포함되어 있습니다. 플러그인은 OS 향상을 위해 설계되었으며 시스템에서 전체 권한으로 실행되며 CA 내에서 명확하게 식별됩니다.
Plugin Note=플러그인 참고사항

; Multi Install
Install Plugin Applications=플러그인 앱 설치
Select all on page=페이지에서 모두 선택
Install Application=앱 설치
Install Applications=복수의 앱 설치
Update Applications=앱 업데이트
Are you sure you want to update %s applications=정말로 %s개의 앱을 설치하시겠습니까
Are you sure you want to install %s docker and %s plugin applications=정말로 %1$s Docker와 %2$s 플러그 앱을 설치하시겠습니까

; Searches
Search=검색
Click Here To Get More Results From DockerHub=DockerHub에서 더 많은 결과를 얻으려면 여기를 클릭하세요
No Matching Applications Found=일치하는 앱을 찾을 수 없음

; Repository Related
%s removed as favourite repository=%s이(가) 즐겨찾는 저장소에서 제거되었습니다.
%s set as favourite repository=%s이(가) 즐겨찾는 저장소로 설정되었습니다.
Click to remove favourite repository=즐겨찾는 저장소를 제거하려면 클릭하세요.
Click to set %s as favourite repository=%s을(를) 즐겨찾는 저장소로 설정하려면 클릭하십시오.
Search for apps in repository=저장소에서 앱 검색
No description present=설명 없음
Go to the forum page=포럼 페이지로 이동
Go to the webpage=웹페이지로 이동
Go to reddit=레딧으로 이동
Go to facebook=페이스북으로 이동
Go to discord=디스코드로 이동
Go to forum profile=포럼 프로파일로 이동
Show Profile=프로파일 보이기
SHOW MORE=더보기
SHOW LESS=덜보기
Read more=더 읽어보기
Total Applications=전체 앱
Total Known Downloads=전체 알려진 다운로드
Total Docker Applications=전체 Docker 앱
Total Plugin Applications=전체 플러그인 앱
Total Languages=전체 언어
Average Downloads Per App=앱당 평균 다운로드 횟수
Web Page=웹페이지
Forum=포럼
Forum Profile=포럼 프로파일
Profile=프로파일
Facebook=페이스북
Reddit=레딧
Twitter=트위터
Discord=디스코드
Search Apps=앱 검색
Registry=레지스트리
Details=상세
Added=추가됨
; Install Plugin title of openbox
Install Plugin=플러그인 설치
Update Plugin=플러그인 업데이트

Requirements not met=요구 사항이 충족되지 않음
The requirements for this upgrade have not been met on your system=이 업그레이드에 대한 요구 사항이 시스템에서 충족되지 않았습니다
The sidebar for the app click info will list the details=앱의 사이드바(정보에 클릭)에 세부 정보가 나열됩니다.

BACK=돌아가기

; Remove App from previously installed
Delete Template=템플릿 제거
Yes, delete it=네, 지우세요

; Uninstall popup
Uninstall Application=앱 제거
Yes uninstall it=네, 지우세요

; Remove Private Application
Remove Private Application=프라이빗 앱 제거
Yes, remove it=네, 지우세요

; App Pinning
Click to pin this application=이 앱을 고정하려면 클릭하세요.
Click to unpin this application=이 앱을 고정 해제하려면 클릭하세요.
Pin App=앱 고정
Unpin App=앱 고정 해제

; Branch installations
Choose A Branch To Install=설치할 분기 선택

; Multiple application installs
; no apps selected
Install Selected Applications=선택한 앱 설치

Yes, install it=네, 설치하세요

; Multi-install popup
Yes, install them=네, 설치하세요
Cookies not enabled Plugins must be separately installed from docker applications=쿠키가 활성화되지 않은 플러그인은 도커 앱과 별도로 설치해야 합니다.
Docker applications will be installed utilizing the most recently saved template with no user input on your part=Docker 앱은 사용자 입력 없이 가장 최근에 저장된 템플릿을 사용하여 설치됩니다.
Updating Support Links=지원 링크 업데이트 중
Downloading docker icons=Docker 아이콘 다운로드 중
Finished Installing If the DONE button did not appear, then you will need to click the red X in the top right corner=설치가 완료되었습니다. 만약 완료 버튼이 보이지 않는다면 오른쪽 상단 모서리에 있는 빨간색 X 버튼을 클릭하세요.

; error messages
No data was returned It is probable that another browser session has rebooted your server Reloading this browser tab will probably fix this error=데이터가 반환되지 않았습니다. 다른 브라우저 세션에서 서버를 재부팅했을 가능성이 있습니다. 이 브라우저 탭을 새로 고침하면 이 오류가 해결될 수 있습니다.
An error occurred Could not find any %s Apps=오류가 발생했습니다. %s 앱을 찾을 수 없습니다.
Download of appfeed failed=앱 피드 다운로드 실패
; the %s here refers to a function being called
Something really went wrong here=알 수 없는 문제가 발생되었습니다.
Post the ENTIRE contents of this message in the Community Applications Support Thread=커뮤니티 앱 지원 스레드에 이 메시지의 전체 내용을 게시하세요.
Unknown error happened Please post a screenshot in the support thread of the Statistics screen=알 수 없는 오류가 발생했습니다 통계 화면의 지원 스레드에 스크린샷을 게시하세요.
Something really wrong happened Reloading the Apps tab will probably fix the problem=알 수 없는 문제가 발생했습니다. 앱 탭을 새로 고침하면 문제가 해결될 수 있습니다.
This plugin has a duplicated name from another plugin %s This will impact your ability to install both plugins simultaneously=이 플러그인에는 다른 플러그인 %s의 이름이 중복되어 있습니다. 이는 두 플러그인을 동시에 설치하는 기능에 영향을 미칩니다.
You have been logged out=로그아웃 되었습니다.
Fatal Flash Drive Error=치명적인 플래시 드라이브 오류
This usually means your flash drive is corrupted or has dropped offline The rest of the Unraid GUI will also be affected Post a new thread in the Unraid forums if this error continues=이는 일반적으로 플래시 드라이브가 손상되었거나 오프라인 상태로 전환됨을 의미합니다. Unraid GUI의 나머지 부분도 영향을 받습니다. 이 오류가 계속되면 Unraid 포럼에 새 스레드를 게시하세요.
Fatal Docker Image Error=치명적 도커 이미지 오류
Your docker image or folder is either read-only or completely full Issues will result because of this You should create a new post in the Unraid forums and include your diagnostics=도커 이미지 또는 폴더가 읽기 전용이거나 완전히 꽉 찼습니다. 이로 인해 문제가 발생합니다. Unraid 포럼에 새 게시물을 만들고 진단사항을 포함해야 합니다.
This template is set up to use a custom network You may have to adjust the network or IP address etc to match your system=이 템플릿은 사용자 지정 네트워크를 사용하도록 설정되어 있습니다. 시스템과 일치하도록 네트워크 또는 IP 주소 등을 조정해야 할 수 있습니다.
This template is set up to run as Privileged This is a possible security risk and usually does not need to be enabled Note that some applications require privileged in order to operate correctly=이 템플릿은 권한이 있는 상태로 실행되도록 설정되었습니다. 이것은 보안상 위험할 수 있으며 일반적으로 활성화할 필요가 없습니다. 일부 응용 프로그램은 올바르게 작동하려면 권한이 있어야 합니다
One or more ports used by this application are already in use by another service or app running on your server You will need to adjust the host ports accordingly on the template=이 응용 프로그램에서 사용하는 하나 이상의 포트가 서버에서 실행 중인 다른 서비스나 응용 프로그램에서 이미 사용 중입니다. 템플릿에 따라 호스트 포트를 조정해야 합니다.
Not Enough Memory=메모리가 부족합니다
Community Applications and Unraid OS have a minimum required installed memory of 4G CA cannot run without those mimimums being met=커뮤니티 앱 및 Unraid OS 에는 4G의 최소 필수 설치 메모리가 있습니다. 이러한 최소값이 충족되지 않으면 CA가 실행할 수 없습니다
Installation already in progress=이미 설치가 진행 중입니다
Another plugin installation or update is already in progress and this one cannot start Wait until the current installation or update is completed and try again=다른 플러그인 설치 또는 업데이트가 이미 진행 중이어서 이 플러그인을 시작할 수 없습니다. 현재 설치 또는 업데이트가 완료될 때까지 기다린 후 다시 시도하세요.
%s is incompatible with your OS version Please update the OS to proceed=%s은(는) OS 버전과 호환되지 않습니다. 계속하려면 OS를 업데이트하세요.
%s is incompatible with your OS version Either uninstall %s or update the OS=%s은(는) OS 버전과 호환되지 않습니다. %s을(를) 제거하거나 OS를 업데이트하십시오.

; CA Sections Keep the length reasonable
Home=홈
Installed Apps=설치된 앱
Previous Apps=이전 앱
Pinned Apps=고정된 앱
Favourite Repo=즐겨찾는 저장소
Action Centre=동작 센터
Recently Added=최근에 추가됨
Random Apps=무작위 앱
Top New Installs=상위 신규 설치
Top Trending Apps=인기 급상승 앱
Spotlight Apps=주목할 앱
All Apps=모든 앱
Statistics=통계
Credits=제작진
Support=지원
VERSION=버전
Change Log=변경 로그
Debugging=디버깅

; Credits
Development=개발
Additional Contributions=추가 기여
GUI Layout Design=GUI 레이아웃 디자인
Application Feed=앱 피드
Additional Testing=추가 테스트
Moderation=조정
Additional Libraries=추가 라이브러리
Copyright=저작권
Translation=번역

; Statistics page

unknown=알 수 없음
Last Change To Application Feed=앱 피드에 대한 마지막 변경 사항
Docker Applications=도커 앱
Plugin Applications=플러그인 앱
Templates=탬플릿
Official Containers=공식 컨테이너
Repositories=저장소
Private Docker Applications=프라이빗 도커 앱
Invalid Templates=잘못된 템플릿
Template Errors=템플릿 오류
Blacklisted Apps=블랙리스트 앱
Incompatible Applications=호환되지 않는 앱
Deprecated Applications=더 이상 사용되지 않는 앱
Moderation Entries=중재 항목
Primary Server=기본 서버
Backup Server=백업 서버
Installs not allowed from this page=이 페이지에서의 설치가 허용되지 않습니다

; Statistics Popup
No invalid templates found=잘못된 템플릿을 찾을 수 없습니다.
These templates are invalid and the application they are referring to is unknown=이 템플릿은 유효하지 않으며 참조하는 앱을 알 수 없습니다.
No templates were automatically fixed=템플릿이 자동으로 수정되지 않았습니다.
All of these errors found have been fixed automatically=발견된 이러한 모든 오류는 자동으로 수정되었습니다.
Note that many of these errors can be avoided by following the directions=이러한 오류의 대부분은 지침을 따르면 피할 수 있습니다.
HERE=여기
The following plugins have duplicated filenames and are not able to be installed simultaneously=다음 플러그인은 파일 이름이 중복되어 동시에 설치할 수 없습니다.
The following docker applications refer to the same docker repository but may have subtle changes in the template to warrant this=다음 도커 앱은 동일한 도커 리포지토리를 참조하지만 이를 보증하기 위해 템플릿에 미묘한 변경이 있을 수 있습니다.
If any of these entries are incorrect then contact the moderators of CA to discuss=이 항목 중 하나라도 잘못된 경우 CA 중재자에게 문의하여 논의하십시오.
Global Repository Comments=글로벌 저장소 평가
Applied to all applications=(모든 앱에 적용됨)
Individual Application Moderation=개별 앱 검토

; Misc
Community Applications Changelog=커뮤니티 앱 변경 로그

Each month we highlight some of the amazing work from our community=매달 우리는 커뮤니티의 놀라운 작업 중 일부를 주목하고 있습니다.
Check out these newly added applications from our awesome community=멋진 커뮤니티에서 새로 추가된 앱을 확인하세요.
Check out these up and coming apps=앞으로 출시될 앱을 확인하세요.
These apps have the highest percentage of new installs=이 앱들은 신규 설치 비율이 가장 높습니다.
An assortment of randomly chosen apps=무작위로 선택된 앱 모음입니다.
Featured Applications=주요 애플리케이션

; Categories try not to be excessively long This is displayed on the left of CA screen

Backup=백업
Cloud=클라우드
Crypto Currency=가상 화폐
Downloaders=다운로더
Drivers=드라이버
Game Servers=게임 서버
Home Automation=가정 자동화
Media Applications=미디어 앱
Books=서적
Music=음악
Photos=사진
Video=비디오
Other=기타
Media Servers=미디어 서버
Network Services=네트워크 서비스
DNS=DNS
FTP=FTP
Management=관리
Messenger=메신저
Proxy=프록시
VOIP=VoIP
VPN=가상사설망
Web=웹
Privacy=개인정보
Productivity=생산성
Security=보안
Spotlight=주목할 앱
Tools Utilities=도구와 유틸리티
System=시스템
Themes=테마
Utilities=유틸리티
Private Apps=개인 앱
Uncategorized=미분류

; Categories displayed within a popup or on the card.  Where an entry exists after the "=" it is not translated, but rather how it should look
GameServers=게임서버
HomeAutomation=가정자동화
MediaApp=미디어앱
MediaAppBooks=미디어앱:도서
MediaAppMusic=미디어앱:음악
MediaAppPhotos=미디어앱:사진
MediaAppVideo=미디어앱:비디오
MediaAppOther=미디어앱:기타
MediaServer=미디어서버
MediaServerBooks=미디어서버:도서
MediaServerMusic=미디어서버:음악
MediaServerPhotos=미디어서버:사진
MediaServerVideo=미디어서버:비디오
MediaServerOther=미디어서버:기타
Network=네트워크
NetworkDNS=네트워크:DNS
NetworkFTP=네트워크:FTP
NetworkManagement=네트워크:관리
NetworkProxy=네트워크:프록시
NetworkVOIP=네트워크:VOIP
NetworkVPN=네트워크:가상사설망
NetworkPrivacy=Network:Privacy
NetworkWeb=네트워크:웹
NetworkOther=네트워크:기타
ToolsSystem=도구:시스템
ToolsThemes=도구:테마
ToolsUtilities=도구:유틸리티
OtherUncategorized=기타:미분류
and %s more=그리고 %s개 이상

; App Popup Related
This application template has been blacklisted=이 앱 템플릿은 블랙리스트에 있습니다.
This application template has been deprecated=이 앱 템플릿은 더 이상 사용되지 않습니다.
This application has additional requirements=이 앱에는 추가 요구 사항이 있습니다.
Additional Requirements=추가 요구 사항
Donate To Author=저작자에게 기부
Donate To Maintainer=유지 보수자에게 기부
CLOSE=닫기
Author=저작자
Maintainer=유지 보수자
DockerHub=DockerHub
Application Template=앱 템플릿
DockerHub Stars=DockerHub 별 수
Added to CA=CA에 추가
Date Updated=업데이트한 날짜
Current Version=현재 버전
Min OS=최소 OS
Max OS=최대 OS
Total Downloads=총 다운로드 수
Popularity=인기
Licence=라이선스
Ranked #%s=#%s 랭크됨
; as in Trending up or down arrow
Trending %s=인기 %s
; as in As of some date
As of %s=(%s 기준)
Play Video=비디오 재생
Play Video %s=비디오 재생 %s
This application is not compatible with your version of Unraid=이 앱은 설치된 Unraid 버전과 호환되지 않습니다
Another browser tab or device has updated the displayed templates Some actions are not available=다른 브라우저 탭 또는 장치가 표시된 템플릿을 업데이트했습니다. 일부 작업을 사용할 수 없습니다.
WebUI=웹 UI
Reinstall=재설치
Reinstall From Previous Apps=이전 앱에서 재설치
Install=설치
Uninstall=제거
Project=프로젝트
Read Me First=먼저 읽어주세요
Install Using The Templates Default Tag=템플릿의 기본 태그를 사용하여 설치하기
Moderator Comments=Moderator 코멘트
Note not all authors keep up to date on change logs=모든 작성자가 변경 로그를 최신 상태로 유지하는 것은 아닙니다
Note not all maintainers keep up to date on change logs=모든 유지 관리자들이 변경 로그를 최신 상태로 유지하는 것은 아닙니다
Last Update=최종 업데이트
Note All statistics are only gathered every 30 days=모든 통계는 30일마다 수집됩니다
;the following if using a space you MUST use nbsp but keep it down to one word if at all possible
Donate=기부하기
Currently Installed Version=현재 설치된 버전
Install The Update=업데이트 설치
; as in you have the latest version already installed
Latest Version=최신 버전
Multi Language Support=다중 언어 지원
Support Forum=지원 포럼
; as in more than 100000
More than %s=%s 이상
Remove from Previous Apps=이전 앱에서 제거
Remove=제거
See All Apps=모든 앱 보기
Favourite=즐겨찾기
Application Type=에플리케이션 타입

; Graphs
Trend Per Month=월간 인기
Downloads Per Month=월간 다운로드 수

; Multi install script
Installing docker applications %s=Docker 앱 %s 설치
Starting %s=%s 시작 중
%s failed to start You should install it by itself to fix the errors=%s을(를) 시작하지 못했습니다. 오류를 수정하려면 자체적으로 설치해야 합니다.
Setting installed applications to autostart=설치된 앱을 자동 시작하도록 설정하기
Docker Application Installation finished=도커 앱 설치 완료

; Application Cards
Actions=동작
Pending=보류 중
This application is a driver plugin=이 앱은 드라이버(플러그인)입니다.
This is a language pack=언어 패키지입니다
This application is a docker container=이 앱은 Docker 컨테이너입니다
This application is a plugin=이 앱은 플러그인입니다
This is a spotlight application=주목받고 있는 앱입니다
This is your favourite repository=당신의 즐겨찾기 저장소입니다
This application is from your favourite repository=이 앱은 즐겨찾는 저장소에서 가져온 것입니다.
This application is pinned for later viewing=이 앱은 나중에 볼 수 있도록 고정되어 있습니다.
Private Application=개인용 앱
Remove Application From List=목록에서 앱 제거
Check off to select multiple reinstalls=다중 재설치를 선택하려면 선택을 해제하십시오.
Go to the plugin settings=플러그인 설정으로 이동하기
Click to reinstall the application using default values=기본값을 사용하여 앱을 다시 설치하려면 클릭하십시오.
Click to edit the application values=앱 값을 편집하려면 클릭하십시오.
Click to reinstall=클릭하여 재설치
Click to install=클릭하여 설치
Click to go to the WebUI=클릭하여 웹UI로 이동
This application template has been deprecated=이 앱 템플릿은 더 이상 사용되지 않습니다.
This application template has been blacklisted=이 앱 템플릿은 블랙리스트에 있습니다.
Click info to see the notes regarding this application=이 앱에 대한 참고 사항을 보려면 정보를 클릭하십시오.
This application has additional requirements=이 앱에는 추가 요구 사항이 있습니다.
BETA=베타
INSTALLED=설치됨
OFFICIAL=공식
UPDATED=업데이트됨
This is an official container=공식 컨테이너입니다
Digitally Signed=디지털 서명됨
This container is digitally signed=디지털 서명된 컨테이너입니다
Docker Hub=Docker 허브
NOTE You must visit the dockerHub page to gather the information required to install correctly=참고사항: 올바르게 설치하는 데 필요한 정보를 수집하려면 dockerHub 페이지를 방문해야 합니다.
Show CA templates=CA 템플릿 표시
Deprecated=지원 중단됨
Incompatible=호환되지 않음
Blacklisted=블랙리스트에 등재됨
Template Exists=템플릿 존재
Template already exists in Apps=템플릿이 앱에 이미 존재합니다
; eg: LinuxServer Repository
%s Repository=%s 저장소
; eg: Squid's Repository
%s's Repository=%s의 저장소

Info=정보
Attention=중요 사항
Repository=저장소
Why we picked it=우리가 그것을 선택한 이유
Application Spotlight %s=앱 주목도 %s
Unraid Staff=Unraid 스태프

; Page Navigation
Displaying %s - %s of %s=%1$s번부터 %2$s번까지의 항목 표시 중(총 항목 수: %3$s개)

Updating Content=항목 업데이트 중
Language=언어
Switch to this language=이 언어로 전환
Country Code=지역 코드
Install Language Pack=언어 팩 설치
Remove Language Pack=언어 팩 제거
Update Language Pack=언어 팩 업데이트
Installed Version=설치된 버전
A note about translations=번역에 대한 참고 사항
Click here to view the language changelog=언어 변경 로그를 보려면 여기를 클릭하십시오
View Missing Translations=누락된 번역 보기

; Update Checks
Check For Updates=업데이트 확인
Check for updates already running=업데이트 확인 작업이 이미 실행 중임
Checking for docker container updates=Docker 컨테이너에 대한 업데이트 확인 중
Checking for plugin updates=플러그인에 대한 업데이트 확인 중
Checking for language updates=언어에 대한 업데이트 확인 중
Checking %s=%s 확인 중

; dockerHub conversions
Determine configuration=구성 결정
Would you like CA to attempt to determine any applicable paths, ports, and variables for the template This will entail performing a test installation of the container It will be automatically deleted after processing The container will not be started=CA가 템플릿에 대해 적용 가능한 경로, 포트 및 변수를 결정하도록 하시겠습니까? 이것은 컨테이너의 테스트 설치를 수행하는 것을 의미합니다. 처리 후 자동 삭제됩니다. 컨테이너가 시작되지 않습니다.
An error occurred - Could not determine configuration=오류가 발생했습니다 - 구성을 결정할 수 없습니다
; WebGui
Click Install to download and install the Community Applications plugin=**설치**를 클릭하여 **커뮤니티 앱** 플러그인을 다운로드하고 설치합니다


; Note: December 8, 2024 - 11 missing translations
Deprecated OS version No further updates to Community Applications will be issued for this OS version=
Update Application=
Run Anyways=
Memory Requirements not met Problems may result=
Clear Flag=
Browser failed to communicate with Unraid Server=
For unknown reasons, your browser was unable to communicate with Community Applications running on your server=
Attempt to Fix Via Reload Page=
External Link=
Clicking OK will take you to a 3rd party website not associated with Limetech=
Install another instance=
